111111P1111111111111
10001000000000000001
109010000000M0000001
10001001111111111001
11011110000000001001
1000G00100G000001001
100K0001000000001001
11111101111100111001
100000000T00000J0001
11111111111111111111