111111P1111111111111
10001000M00000000001
10901000000000000001
10001001111111111001
11011110000000001001
1000000100G000001001
10000G01000000001001
11111101111100111001
100000000A00000J0001
11111111111111111111