11111111111111111111
100000000010000000A1
10000000001000J00001
10009000001000000001
1000000H0A0000001111
11111100000000000001
1A000000T00000000001
100000000H000A000001
100000G00000J0000001
11111111000011111111
100000000AH000000001
10000000M00000000001
111111111P1111111111