11111111111111111111
100000000010000000A1
10000000001000J00001
10009000001000000001
10000000000000001111
11111100000000000001
1A000000T0000M000001
100000000H0000000001
100000G00000K0000001
11111111000011111111
100000000000000000H1
10000000J00000000001
11111111111111111111