11111111111111111111
13333333333333333331
131113311133333E3331
13111331113311113331
13333333333311113331
133E3333B33333333331
11111331111113311111
11111331111113311111
133333333H3333333A31
13311133311133311131
1331K13331E133311131
13311133311133333331
1333333333333333P331
13333E33333333333331
11111111111111111111