11111111111111111111
13333333333333333331
13223333333333332231
13223333H33H33332231
13333333333333333331
133333333K3333333331
13333333333333333331
13A33333333333333A31
13333333333333333331
13333333333333333331
13223333333333332231
13223333H33H33332231
13333333333333333331
133333333J3333333331
11111111111111111111