111111111P1111111111
100000000M0000000001
100000000H0000000001
10000000K00000000001
11110000000000001111
100000J000000T000001
10H000000K000000H001
10000000000000000001
11110000000000001111
1H0000000000000000H1
1A0000000900000000A1
1A0000000000000000A1
11111111111111111111